d,d,n,n,n,n,n,n,n,n,d,d
d,d,n,n,n,n,n,n,n,n,d,d
d,d,n,n,n,n,n,n,n,n,d,d
d,d,n,n,h,h,h,h,n,n,d,d
d,d,n,n,h,n,n,h,n,n,d,d
d,d,n,n,h,n,n,h,n,n,d,d
d,d,n,n,n,n,n,n,n,n,d,d
d,d,n,n,h,n,n,h,n,n,d,d
d,d,n,n,h,n,n,h,n,n,d,d
d,d,n,n,h,h,h,h,n,n,d,d
d,d,n,n,n,n,n,n,n,n,d,d
d,d,n,n,n,n,n,n,n,n,d,d