n,n,n,n,n,n,n,n,n,n,n,n
n,n,n,n,n,n,n,n,n,n,n,n
n,n,n,n,n,n,n,n,n,n,n,n
n,n,n,n,h,h,h,h,n,n,n,n
n,n,n,n,h,n,n,h,n,n,n,n
n,n,n,n,h,n,n,h,n,n,n,n
n,n,n,n,n,n,n,n,n,n,n,n
n,n,n,n,h,n,n,h,n,n,n,n
n,n,n,n,h,n,n,h,n,n,n,n
n,n,n,n,h,h,h,h,n,n,n,n
n,n,n,n,n,n,n,n,n,n,n,n
n,n,n,n,n,n,n,n,n,n,n,n